Best Group of Bad Asses | Best Group of Bad Asses in a Motion Picture | nominee: {'name': 'Best Group of Bad Asses | Best Group of Bad Asses in a Motion Picture | nominee', 'nominees': ['Best Group of Bad'], 'votes': 1}
Best Exotic Marigold Hotel | Best Exotic Marigold Hotel | nominee: {'name': 'Best Exotic Marigold Hotel | Best Exotic Marigold Hotel | nominee', 'nominees': ['Exotic Marigold Hotel'], 'votes': 1}
really excited to see if Andrew McCutchen wins a Golden Globe: {'name': 'really excited to see if Andrew McCutchen wins a Golden Globe', 'nominees': ['Andrew McCutchen'], 'votes': 1}
best actress in a drama television series | winner: {'name': 'best actress in a drama television series | winner', 'nominees': ['Ben Affleck', 'Jennifer Lawrence', 'Adele', 'Daniel Day Lewis', 'Christoph Waltz', 'Anne Hathaway', 'Best Actor', 'Claire Danes', 'Les Miserables', 'Jessica Chastain', 'Quentin Tarantino', 'Bill Clinton', 'GoldenGlobes', 'Lena Dunham', 'Don Cheadle', 'Damian Lewis', 'Best Original Song', 'Kevin Costner', 'Julianne Moore', 'Best Animated Feature Film', 'Day Lewis', 'Maggie Smith', 'Best Actress', 'Best Animated Film', 'Best Song', 'JenniferLawrence', 'Lawrence', 'BenAffleck', 'MaggieSmith', 'Best Drama', 'Ed Harris', 'Television Comedy', 'GameChange', 'Best Comedy', 'Best Picture', 'Best Mini', 'Lincoln', 'Damien Lewis', 'Score for Life of Pi', 'Jean Valjean', 'LesMiserables', 'Hugh Jackman', 'Bill Murray', 'Mychael Danna', 'Song', 'Best Foreign Film', 'Amy Poehler', 'Idiocy of # OscarNoms Affleck', 'Catherine Zeta Jones', 'Cajas', 'HBO', 'Best Original Song Motion Picture', 'Skyball', 'AnneHathaway', 'Quentin', 'SHOW', 'Best Animated Feature', 'GIRLS', 'GoldenGlobes Les Miserables', 'Oscar', 'Jon Bon Jovi', 'Selena Gomez', 'Clinton', 'Best TV Movie', 'GoldenGlobes Julianne Moore', 'GoldenGlobes Life', 'Best Original Score', 'Taylor Swift', 'Tommy Lee Jones', 'GoldenGlobes Ed Harris', 'Amanda Seyfried', 'Django Unchained', 'Screenplay for Django', 'ClaireDanes', 'Queen Madonna', 'Non - Oscar', 'Ben # Affleck', 'Best Musical', 'ben afleck', 'Oscars', 'Best Picture &', 'Drama', 'Woah Ben Affleck', 'Lez Messyrobla', 'Best Actor In a Motion Picture', 'Sofia Vergara', 'Newsroom', 'Claire Danes Best Actress TV', 'Dustin Hoffman', 'Tina Fey', 'Waltz', 'Christopher Waltz', 'Cristoph Waltz', 'Jared Leto', 'Supporting Actor', 'ChristophterWaltz', 'Best Miniseries', 'Best Miniseries or TV Movie', 'Miniseries', 'Best Mini Series or TV Movie', 'Julianne', 'Julianna Moore', 'JulianneMoore', 'GoldenGlobes Game Change', 'Jon Hamm', 'Best TV Drama Series', 'HOMELAND', 'Fargo', 'LifeOfPie', 'Michael Danna', 'Madonna', 'taylor', 'Yayyyy Adele', 'Yaaaaay', 'Original Song for Motion Picture', 'Jessica Alba', 'Best Animation Golden Globes', 'jessica alba', 'Pimp Billy', 'Feral', 'LINCOLN', 'Mandy Patinkin', 'John Krasinski', 'LOLOL Amanda Seyfried', 'Tarentino', 'Billy Murray', 'Best Foreign Language Film', 'Clare Danes', 'QT', 'Globes Jennifer Lawrence', 'Anne Hathway', 'AzizAnsari', 'Jack', 'Best Actress In A Comedy for Silver Linings Playbook', 'Mel Gibson', 'Halle Berry', 'Ben Afleck', 'Hooray', 'Yay Ben Affleck', 'Academy', 'Comedy', 'XOXOXOXO', 'Best TV Series Comedy or Musical', 'Best TV Comedy', 'Best Comedy TV Series', 'LenaDunham', 'Ben Afflect', 'Best Actor Comedy', 'Best Actor Motion Picture', 'Les Mis--', 'HughJackman', 'Best Husband', 'jennifer lawrence', 'Les Miserable', 'Awesome Les Miserables', 'Les Miz', 'LesMis', 'Best Actor &', 'Globe', 'BEST PICTURE - MUSIC OR', 'DDL', 'Best Actor of All', 'Motion Picture', 'Arsego', 'Best Drama Movie', 'Best Picture by Foreign Press', 'wajib', 'Best Pic', 'Best Motion Picture Drama &', 'Mitt Romney', 'Gandhi', 'Best Drama Film', 'Amy', 'Jessica Lange', 'Best Actor TV Series', 'Kate Hudson', 'Golden Globes', 'ActofValor', 'Kristen Wig', 'NONE', 'BestActress', 'Schmidt', 'Sam Jackson', 'Best Picture Golden Globe', 'Tom Hooper', 'Jeremy Irons', 'Jlo', 'Mhissy', 'ParaNorman', "Jodie Foster 's", 'the Oscars SHOULD', 'AskGlobes', 'BenAfflek', 'Jeremy Renner', 'Black Coffins', 'Best Actress - Musical', 'Safe &', 'Gangster Squad', 'Ang Lee', 'Liz &'], 'votes': 2}
Best Supporting Actor for motion picture | winner: {'name': 'Best Supporting Actor for motion picture | winner', 'nominees': ['Christoph Waltz'], 'votes': 1}
best actress for Silver Linings Playbook | winner: {'name': 'best actress for Silver Linings Playbook | winner', 'nominees': ['Jennifer Lawrence'], 'votes': 1}
best actress in TV drama for her work on | winner: {'name': 'best actress in TV drama for her work on | winner', 'nominees': ['Claire Danes'], 'votes': 1}
Best TV series -Comedy or Musical at the | winner: {'name': 'Best TV series -Comedy or Musical at the | winner', 'nominees': ['-Comedy or Musical'], 'votes': 1}
best actor in a drama for Lincoln at the | winner: {'name': 'best actor in a drama for Lincoln at the | winner', 'nominees': ['Daniel Day Lewis'], 'votes': 1}
Best Supporting Actress for her work in | winner: {'name': 'Best Supporting Actress for her work in | winner', 'nominees': ['Anne Hathaway'], 'votes': 2}
Best Director for Argo in the Oscars | nominee: {'name': 'Best Director for Argo in the Oscars | nominee', 'nominees': ['Oscars'], 'votes': 1}
Best Actress in a Comedy at the 2013 | winner: {'name': 'Best Actress in a Comedy at the 2013 | winner', 'nominees': ['Best Actress'], 'votes': 1}
Best Acceptance Speech of the Night | winner: {'name': 'Best Acceptance Speech of the Night | winner', 'nominees': ['Adele'], 'votes': 1}
Best Actor in a Miniseries or Motion Picture: {'name': 'Best Actor in a Miniseries or Motion Picture', 'nominees': ['Kevin Costner'], 'votes': 1}
Best nominee cutaway of the night | nominee: {'name': 'Best nominee cutaway of the night | nominee', 'nominees': ['Amy Poehler'], 'votes': 1}
best actress in a drama series | nominee: {'name': 'best actress in a drama series | nominee', 'nominees': ['GoldenGlobes'], 'votes': 1}
Best Musical or Comedy after | winner: {'name': 'Best Musical or Comedy after | winner', 'nominees': ['LesMiserables'], 'votes': 1}
Best Supporting Actress in | winner: {'name': 'Best Supporting Actress in | winner', 'nominees': ['Anne Hathaway'], 'votes': 1}
best foreign language film | winner: {'name': 'best foreign language film | winner', 'nominees': ['Best Foreign Language Film'], 'votes': 1}
best speech of the night | winner: {'name': 'best speech of the night | winner', 'nominees': ['Adele'], 'votes': 1}
Best Husband of the Year | winner: {'name': 'Best Husband of the Year | winner', 'nominees': ['Hugh Jackmon'], 'votes': 1}
best supporting actress | winner: {'name': 'best supporting actress | winner', 'nominees': ['Anne Hathaway', 'Maggie Smith', 'Best Supporting Actress', 'GoldenGlobes Anne Hathaway', 'Hathaway'], 'votes': 1}
Best seat in the house | winner: {'name': 'Best seat in the house | winner', 'nominees': ['Amy'], 'votes': 1}
Best Comedy or Musical | winner: {'name': 'Best Comedy or Musical | winner', 'nominees': ['Les Miserables', 'Best Comedy or Musical'], 'votes': 1}
Best Tux of the night | winner: {'name': 'Best Tux of the night | winner', 'nominees': ['Ben Affleck'], 'votes': 1}
Best Song | Best Song | winner: {'name': 'Best Song | Best Song | winner', 'nominees': ['Best Song'], 'votes': 1}
best animated film at | winner: {'name': 'best animated film at | winner', 'nominees': ['GoldenGlobes'], 'votes': 1}
Best Actress in Mini | winner: {'name': 'Best Actress in Mini | winner', 'nominees': ['Julianne Moore'], 'votes': 1}
Best Motion Picture | winner: {'name': 'Best Motion Picture | winner', 'nominees': ['Les Miserables', 'LesMiserables', 'Ben Affleck', 'Motion Picture'], 'votes': 1}
Best Animated film | nominee: {'name': 'Best Animated film | nominee', 'nominees': ['Best Animated Film', 'Animated Film', 'Best Animated'], 'votes': 1}
best actress for | winner: {'name': 'best actress for | winner', 'nominees': ['Jessica Chastain', 'J. Lawrence', 'Claire Danes'], 'votes': 1}
best show on tv | nominee: {'name': 'best show on tv | nominee', 'nominees': ['GoldenGlobes'], 'votes': 1}
best TV actor | nominee: {'name': 'best TV actor | nominee', 'nominees': ['Si Robertson'], 'votes': 1}
best actor award would: {'name': 'best actor award would', 'nominees': ['GoldenGlobes'], 'votes': 1}
best musical | winner: {'name': 'best musical | winner', 'nominees': ['Les Miserables'], 'votes': 1}
BEST ACTOR | nominee: {'name': 'BEST ACTOR | nominee', 'nominees': ['Tina Fey', 'ANDREW LINCOLN', 'Damian Fransisco'], 'votes': 1}
best Life | winner: {'name': 'best Life | winner', 'nominees': ['Bill Murray'], 'votes': 1}
Michael J. Fox |: {'name': 'Michael J. Fox |', 'nominees': ['Michael J. Fox'], 'votes': 1}
every: {'name': 'every', 'nominees': ['Maggie Smith', 'Everytime Life', 'Walter White', 'Lewis'], 'votes': 1}
