Dustin Hoffman | best personality on the red carpet tonight | winner
he | Best Director for Argo in the Oscars | winner
Bill Murray | best facial hair of the night | winner
linings | best movie | winner
Tina Fey | best dressed | winner
Christoph Waltz | Best Supporting Actor in a Motion Picture for his role in Django Unchained | winner
# goldenglobes | Best American accent by a Brit in a major TV series | winner
Django | best screenplay | winner
The actor | best actor alive | winner
Christopher Waltz | best supporting actor | winner
Cristoph Waltz | best supporting actor | winner
Maggie Smith | Best Supporting Actress for TV performance for Downton Abbey | winner
a Dowager Countess | him we need a Dowager Countess wins an | winner
Actress | Best Supporting Actor | winner
Katherine Bigelow | the Leni Riefenstahl | winner
MaggieSmith | Best Supporting Actress & amp | winner
I | a separate | winner
she | Taylor Swift right now that she ca n't do her annoying surprise face whenever she wins an | winner
ChristophterWaltz | Best Supporting Actor for Django Unchained | winner
# GameChange | best mini | winner
Game Change | his remote threw the TV as Game Change wins another | winner
GameChange | best mini | winner
yoshiki | special | winner
GoldenGlobes game Change | best mini series/ TV movie | winner
the Palin thing | best TV movie | winner
# MaggieSmith | Best Supporting Actress in a TV Movie | winner
Julianne | best | winner
Julianne Moore | Best Performance by an Actress in a TV series at the | winner
it | best picture over Lincoln | winner
.@_JulianneMoore | Best Actress in a Miniseries or Motion Picture Made for Television for Game Change | winner
Julianna Moore | best actress for miniseries | winner
JulianneMoore | Best Actress in a TV Series for | winner
GoldenGlobes Julianne Moore | Best Actress in a Mini Series or TV movie | winner
Yay | Best Actor in a Television Series | winner
The Latina lady | the sassy stereotype in the most overrated sitcom ever | winner
HBO | best actress in a television series | winner
Ben Affleck | Best Director Award at Golden Globes for Argo | winner
Everybody | Best part of the Golden Globes | winner
Damian Lewis | Best Supporting Ginger Who Also Makes My Panties Wet | winner
Damien Lewis | Best Actor in a TV Series for his role in Homeland | winner
Homeland | Best Telelvision Series at the Golden Globes | winner
Jon Hamm | Best Actor in a TV show | winner
who | best soundtrack score for the golden globes tonight | winner
# Homeland | Best TV Drama Series | winner
OoOoO # Homeland | best show on the tube | winner
GoldenGlobes | Best Actor in a Motion Picture in the Comedy or Musical category for Les Miserables | winner
WINNER | best actress in a | winner
something | best show in the history of TV | winner
Brit Damien Lewis | best actor in a drama at the Golden Globes in LA | winner
FuckYeah # Homeland | best TV series drama | winner
LifeOfPie | Best Original Score | winner
GoldenGlobes Life | Best original score | winner
Life | best song for Skyfall | winner
Everytime Life | an | winner
Jennifer Lopez | the | winner
Canada | best Score for Life of Pi | winner
favorite | Best Score category | winner
Mychael Danna | Best Supporting Actor for Django Unchained | winner
Michael Danna | best original score for LIFE OF PI | winner
Madonna | Best Song for WE | winner
taylor swift | best original song at the golden globes ill be | winner
Skyfall | best Original Song for Motion Picture at the Golden Globes | winner
Adele | best song for the theme to Skyfall and Maggie Smith wins best supporting actress in a s | winner
Yayyyy Adele | Best Original Song for Skyfall | winner
# argo | best drama I ' m sure a good movie but it | winner
# Skyfall | best original song in a motion picture | winner
singer Adele | Best Original Song at the Golden Globes in LA for Skyfall | winner
Yaaaaay | Best Song at the | winner
Canadian | Golden Globe | winner
tv appearance | Best Original Song for | winner
This lady | on banning Adele out of all | winner
None | best director and best picture at Golden Globes | winner
Best Song | Best Song | winner
Best Original Song | Best Original Song for | winner
jessica alba | best everything | winner
# riseoftheguardians | best | winner
Kevin Costner | Best Actor in a Miniseries or Motion Picture Made for Television for Hatfields & amp | winner
GoldenGlobes Kevin Costner | Best Actor in a mini | winner
McCoys | Best Actor in a Mini | winner
Bill Clinton | best actor who did not have sex with that woman | winner
Pimp Billy | best reaction to Pimp Billy the Real 's entrance | winner
that | There must be SOME category where that wins him an | winner
R2D2 | Best | winner
Lincoln | best actor for | winner
Feral | best presenter of any award | winner
Tommy Lee Jones | best facial expression | winner
Jennifer Lawrence | Best Actress Motion Picture Comedy or Musical for Silver Linings Playbook | winner
JenniferLawrence | Best Actress Motion Picture | winner
Lawrence | best actress in comedy or musical in film | winner
J Law | Best Actress in a Comedy at the 2013 | winner
movie | best actress in a comedy or musical movie for | winner
GoldenGlobes Jennifer Lawrence | best actress in a motion picture comedy or musical | winner
Whohoooo # JenniferLawrence | best movie of the year | winner
every award | With every | winner
Ed Harris | Best supporting actor in a TV movie or miniseries Best actor on TV | winner
GoldenGlobes Ed Harris | Best Supporting Actor | winner
Mandy Patinkin | best beard on an old guy who played Inigo Montoya in | winner
Andrew McCutchen | I ' m really excited to see if Andrew McCutchen wins a Golden Globe award to go with his Golden Glove | winner
Anne Hathaway | Best Supporting Actress in a Motion Picture for Les Miserables at the | winner
GoldenGlobes Anne Hathaway | best supporting actress | winner
John Krasinski | best dressed and best smile | winner
A boy | best actress in a drama | winner
student Anne Hathaway | best supporting actress for | winner
# AnneHathaway | best supporting actress for | winner
Quentin Tarantino | best incorporating foot fetishes into a script | winner
Tarantino | best screenplay | winner
FUCK YES Quentin Tarantino | Best Original Screenplay | winner
Quentin | Best Original Screenplay | winner
Amanda Seyfried | Best Gauze Bandage | winner
Django Unchained | Best Screenplay | winner
LOLOL Amanda Seyfried | Best Gauze Bandage | winner
Tarentino | best director at the | winner
Don Cheadle | best performance by Don Cheadle in a show nobody likes at all but it | winner
.@IamDonCheadle | Best Actor in TV Series 4"House of Lies | winner
GoldenGlobes Don Cheadle | best actor in a comedy or musical TV series for | winner
J. Lawrence | best actress for | winner
Quentin # Tarantino | best Screenplay for Django | winner
Billy Murray | best facial hair | winner
Amour | best foreign language film for Austria | winner
# Amour | best foreign film | winner
Hathaway | best supporting actress | winner
Claire Danes | Best Performance by an Actress In A Television Series | winner
Anytime Angela Chase | an | winner
people | best part of the | winner
Clare Danes | best actress in drama | winner
crush Jennifer Lawrence | Best Actress at the Golden Globes | winner
Goldenglobes Claire Danes | best actress for a tv mini series for | winner
QT | Best Screenplay | winner
A Claire Danes | best actress in TV drama | winner
# ClaireDanes | Best Actress TV Series- Drama for | winner
Globes Jennifer Lawrence | Best Actress | winner
thing | BEST PART OF THE SHOW | winner
AnneHathaway | Best Supporting Actress at | winner
Leo | best part of MY night | winner
Brave | Best Animated Feature Film at the | winner
Best Animated Feature Film | Best Animated Feature Film | winner
# Brave | best animated feature film award | winner
Anne Hathway | Best Supporting Actress in a Motion Picture | winner
The archery lady | Best Animated Feature Film | winner
Brody | best actor and actress respectively in drama series | winner
Amy Poehler | Best Actress in a Comedy | winner
Lena Dunham | best performance by an actress in a TV musical or comedy for | winner
# AzizAnsari | best weed backstage | winner
.@lenadunham | Best Performance By An Actress in TV Comedy Or Musical | winner
Jack | Best TV Actress in a Comedy from Girls | winner
Amy | Best seat in the house | winner
Hoping | Best Director for Argo so he can tell to suck it | winner
Best Actress | Best Actress in a Comedy TV series | winner
Globes | best foreign language film | winner
The actress | Best Actress In A Comedy for Silver Linings Playbook | winner
star Lena Dunham | important | winner
Queen Madonna | Best Original Song | winner
mom Adele | Best Song | winner
Jodie Foster | an extremely deserved honorary Cecille B. DeMille | winner
Mel Gibson | best speech writer | winner
Halle Berry | Best Dressed for sure | winner
Affleck | Best Director award at the | winner
Non - Oscar | best director for awesome Argo | winner
Argo | Best Motion Picture Drama yet it was n't nominated for an Oscar | winner
Idiocy of # OscarNoms Affleck | best director | winner
snub Ben Affleck | Best Director for | winner
BenAffleck | Best Director for Argo | winner
Hooray | best director for | winner
Yay Ben Affleck | Best Director | winner
Ben # Affleck | Best Director | winner
.@BenAffleck | Best Director for | winner
Jennifer Gardner | the pretty | winner
man | best director | winner
Girls | Best TV series -Comedy or Musical at the | winner
Hey , Academy | Best Director at the Golden Globes | winner
HA | GoldenGlobes director | winner
# Girls | best Best Television Comedy | winner
XOXOXOXO | Best Television Show Musical | winner
ben afleck | best director at the golden globes | winner
a show | best comedy | winner
# BenAffleck | Best Director | winner
# LenaDunham | best TV comedy for Girls | winner
Ben Afflect | best director for the ARGO film | winner
Hugh Jackman | best actor in a musical or comedy at the Golden Globes for Les Mis | winner
LesMis | Best Motion Picture | winner
category Hugh Jackman | Best actor | winner
crush Hugh Jackman | best actor in a comedy or musical | winner
the guy | Best Actor in a comedy or musical | winner
# HughJackman | best actor for | winner
Hugh Jackmon | Best Husband of the Year | winner
Jean Valjean | Best Actor in Musical | winner
Wolverine | Best Actor for a movie | winner
Aaaand Hugh Jackman | Best Husband at the | winner
Bradley Cooper | the hottest human being alive | winner
Chastain | best actress I ' m | winner
Daniel Day Lewis | best actor in a drama for his masterful performance in | winner
a boo | Best Director for Argo | winner
Les Miserables | Best Motion Picture for Comedy | winner
Les Miz | Best Picture | winner
# LesMiserables | Best Musical or Comedy after | winner
Les Mis | best musical for the Golden Globes | winner
Les Miserable | best comedy | winner
Congrats Les Mis | Best Comedy | winner
anddd Les Miserables | Best Picture for Comedy | winner
Argo director | Best Director | winner
Awesome Les Miserables | best movie comedy or musical at the Golden Globes | winner
Best Motion Picture | Best Motion Picture | winner
# LesMis | best musical or comedy at the | winner
Moonrise Kingdom | an | winner
.@LesMiserables | Best Motion Picture | winner
GoldenGlobes Hugh Jackman | best actor for Les Miserables | winner
Best Actor & | Best Actor & amp | winner
GoldenGlobes Les Miserables | Best Motion Picture Comedy or Musical | winner
Michael J. Fox | award | winner
Jessica Chastain | Best Actress for Drama for the movie ZERO DARK THIRTY | winner
BEST PICTURE - MUSIC OR | BEST PICTURE | winner
the underdog | best | winner
girl | Best Actress | winner
lesmiz movie | best musical picture at | winner
Best Actor- Drama | Best Actor- Drama | winner
DDL | best | winner
Day Lewis | Best Actor in a Motion Picture in the Drama category for Lincoln | winner
The Best Actor | Best Actor of All | winner
This | Best Actor in a Motion Picture | winner
Daniel Day - Lewis | Lewis wins | winner
Trouble | best picture | winner
The film | Best Motion Picture | winner
The Jessica Chastain | Best Actress | winner
Arsego | best picture | winner
movies | Best Drama over | winner
Woah Ben Affleck | best drama for Argo | winner
# | best | winner
film wajib tonton ini | best actor | winner
Chris Tucker | for next year when Chris Tucker wins the Cecil B. DeMille | winner
Mitt Romney | Best Actor | winner
Review | Best Actress at | winner
Gandhi school | best school in asia | winner
India Ben Affleck | Best Director for Argo at Golden Globes 2013 | winner
LesMiserables | Best Motion Picture | winner
a video Jennifer Lawrence | Best Actress | winner
